-19
21
-12
16
00000000000000000000000000000000000000000
00000000000000000000000000000000000000000
11111111111111111111111111111111111111111
00000000000000000000000000000000000000001
00000000000000000011000000000000000000001
00000000000000000011000000000111000000001
00000011100000000011000000000111000000001
00000011100000000000000000000111000000001
00000011100000000000000000000111000000001
00000011100000000000000000000000000000001
00000000000000000000000000000000000000001
00000000000000000000000000000000000000001
00000000000000000000000000000000011110001
00000000000000000000000000000000011110001
00000000000000000000001000000000011110001
00000000010000000000000000000000000000001
00000000000000000000000000000000000000001
00000000000000000000000000000000000000001
00000000000000000000000000000001100000001
00000000000000100000000000000001100000001
00000000000000000000000000010001100000001
00000000000000000000000000000000000000001
00000000000000000000000000000000000000001
00000000000000000000000000000000000000001
00000000000110000000000001100000000000001
00000110000110000000000001100000000000001
00000110000110000000000001100000000000001
00000110000000000000000000000000000000001
00000000000000000000000000000000000000001
